8BIT -> 8bitCoin
AC -> AsiaCoin
ADA -> Cardano
ADN -> Aiden
ADX -> AdEx
ANAL -> AnalCoin
ANT -> Aragon
AR -> ARCoin
ARCH -> ArchCoin
ARK -> ARK
BBR -> Boolberry
BCAT -> BlackCATCoin
BCH -> Bitcoin Cash
BCY -> BitCrystals
BDG -> BadgerCoin
BLK -> BlackCoin
BNT -> Bancor
BOST -> BoostCoin
BRIT -> British Digital Coin
BSV -> Bitcoin Satoshi Vision
BT -> BitcoinT
BTC -> Bitcoin
BTCD -> BitcoinDark
BTM -> Bitmark
BURN -> BurnCoin
C2 -> Coin 2.1
CAI -> CaiShen
CANN -> CannabisCoin
CC -> CyberCoin
CCX -> CornerstoneCoin
CF -> Californium
CFC -> CoffeeCoin
CINNI -> CinniCoin
CKC -> CheckCoin
CLOAK -> CloakCoin
COVAL -> Circuits of Value
CRY -> CryptCoin
CRYPT -> CryptCoin
CTO -> CTO
CURE -> CureCoin
CYP -> Cypher
DASH -> DashCoin
DCM -> Digital Commerce
DCR -> Decred
DGB -> DigiByte
DIME -> DimmeCoin
DIS -> DistroCoin
DOGE -> DogeCoin
DRK -> DarkCoin?
DRM -> DreamCoin
DRS -> Denarius
DRZ -> Droidz
ELT -> Electron
EMC2 -> Einsteinium
ERC -> EuropeCoin
ETC -> Ethereum Classic
ETH -> Ethereum
EUR -> Euro
EXE -> ExeCoin
EXP -> Expanse
FCT -> factom
FIBRE -> Fibre
FLO -> FlorinCoin
FLDC -> FoldingCoin
FLT -> FlutterCoin
FRAC -> FractalCoin
FRSH -> FreshCoin
GAM -> Gambit
GBYTE -> Byteball
GEO -> GeoCoin
GHOST -> GhostCoin
GIZ -> GIZMOCoin
GLIDE -> GlideSEC
GLYPH -> GlyphCoin
GNO -> Gnosis
GOAL -> GoalCoin
GPH -> GraphCoin
GPUC -> GPUCoin
GRCX -> Gridcoin
GRN -> Granite
GRS -> GroestlCoin
HC -> HonorCoin
HMY -> HarmonyCoin
HUGE -> BigCoin
HYPER -> HYPER Game Currency
HZ -> HertzCoin
HZT -> HazMatCoin
INT -> IntelliCoin
IOC -> I/O Coin
ISR -> IsraCoin
JBS -> Jumbucks
KEY -> KeyCoin
KORE -> KoreCoin
KTK -> KryptKoin
LBC -> LBRY Credits 
LDOGE -> LiteDoge
LGC -> LogiCoin
LION -> LION
LIT -> LightCoin
LSK -> Lisk
LTC -> LiteCoin
LTCX -> LiteCoinX
LXC -> LibrexCoin
LUN -> Lunyr
MAID -> MaidSafe
MAMM -> MammothCoin
MAST -> MastCoin
MEOW -> KittehCoin
MIN -> Minerals
MUE -> Monetary Unit
MUGA -> MugatuCoin
MYST -> MysteryCoin
NAUT -> NautilusCoin
NAV -> NavajoCoin
NEOS -> NeosCoin
NIRO -> Nexus
NLG -> GuldenCoin
NOTE -> DNotes
NTRN -> Neutron
NXT -> NXT
OC -> OrangeCoin
OK -> OkCash
OPAL -> Opal
OPC -> OPECCoin
PAY -> TenX
P7C -> P7Coin
PASC -> PascalCoin
PC -> PinkCoin
PIG -> PiggyCoin
PIGGY -> PiggyCoin
PINK -> PINKCoin
PIVX -> Private Instant Verified Transaction
PND -> PandaCoin
PPC -> PeerCoin
PRO -> XPRO
Q2C -> QuBitcoin
QORA -> Qora
QTL -> Quatloo
QUID -> QuidCoin
RADS -> Radium
RAW -> RawCoin
RDD -> ReddCoin
RTC -> RightCoin
RZR -> Razor
SC -> SiaCoin
SDC -> ShadowCoin
SFR -> SaffronCoin
SHELL -> ShellCoin
SHLD -> ShieldCoin
SIGU -> Singular
SIS -> SiameseCoin
SLING -> SLING
SPA -> SpainCoin
SPHR -> Sphere
START -> StartCoin
STRAT -> Stratis
SUM -> SummerCoin
SUM2 -> SummerCoin 2.0
SUP -> SupCoin
SUPER -> SuperCoin
SYNC -> SYNC
SYS -> SysCoin
TAC -> TalkCoin
TEA -> TeaCoin
TES -> TeslaCoin
THC -> HempCoin
TRON -> Positron Technologies
UNO -> Unobtanium
URO -> UroCoin
USD -> US Dollar
USDT -> Tether
UVC -> UniversityCoin
VIA -> ViaCoin
VOOT -> VootCoin
VRC -> VeriCoin
VTC -> VertCoin
VVV -> VeniVidiVici-Coin
WC -> WhiteCoin
WAVES -> Waves
WEST -> WildWestCoin
XAI -> Sapience
XBC -> BitcoinPlus
XBS -> Bitstake
XC -> XCurrency
XCP -> Counterparty
XEL -> Decentralized Supercomputer
XFC -> FinerCoin
XLB -> LibertyCoin
XLC -> LiteCoinPlus
XLM -> Stellar
XMR -> Monero
XMY -> MyriadCoin
XPM -> PrimeCoin
XPY -> PayCoin
XRP -> Ripple
XSI -> StabilityShares
XTZ -> Tezos
XVC -> VCash
YANG -> YangCoin
YC -> YellowCoin
YIN -> YinCoin
YMC -> YamahaCoin
ZEC -> Zcash
ZET -> ZetaCoin
ZS -> Zimstake
_BCH -> Bluechip
_SC -> SiaCoin Pre-Fork
