// Different names for currencies at kraken.com
// One line for each currency.
// Kraken currency names on the left (separated by commas).
// Normalized currency name on the right.

ADA       -> ADA
BCH       -> BCH
DASH      -> DASH
EUR, ZEUR -> EURO
LINK      -> LINK
NANO      -> NANO
XBT, XXBT -> BTC
XETC      -> ETC
XETH      -> ETH
XICN      -> ICN
XLTC      -> LTC
XMLN      -> MLN
XNMC      -> NMC
XREP      -> REP
XTZ       -> XTZ
XXDG, XDG -> DOGE
XXLM      -> XLM
XXMR      -> XMR
XXRP      -> XRP
XXVN      -> XVN
XZEC      -> ZEC
ZCAD      -> CAD
ZGBP      -> GBP
ZJPY      -> JPY
ZKRW      -> KRW
ZUSD, USD -> USD
